lv1
###############
#.............#
#.-----------.#
#.-...........#
#.-----------.#
#...........-.#
#.-----------.#
#.-...........#
#.-----------.#
###############


lv5_0
lv4_3
lv3_2
lv2_1
lv1_0