...###....
..##.#.###
.##..###..
##........
#@.#.#.#..
########..
..#..#....
.##.##.#.#
.#......##
.#.....##.