lv1
#.2--------L###
#.-..........##
#.8--------1.##
#..........-###
#.r--------6#.#
######.###.####
##.#.######.###
#.#######.#####
######.########
##.##########.#
###############

lv2
###############
#.............#
#.-----------.#
#.-...........#
#.-----------.#
#...........-.#
#.-----------.#
#.-...........#
#.-----------.#
###############


lv5_0
lv4_3
lv3_2
lv2_1
lv1_3